11111111110000000000000000000000000000
1110000P110000000000000000000000000000
10000000110000000000000000000000000000
10111111111111000000000000000000000000
10111100010001000000000000000000000000
10000001000101111111111110000000000000
11111111111100000111111111111111111111
11111111111100000111111111110CCCCCC011
11111111111101101111111111111111011111
11111111111101100000000000000000011111
11111111111001111111111111111111011111
10000000000011000000000000000001001111
10111111111111111111111111111111101111
10000L00000001000000000000000000001100
11111111111101011111111111111111111111
11111111111001001111111111000000000000
11111111111011101111111111111110000000
11111111111000001111111111111111111111
11111111111110111111111111111111111111
111111111111100000000000F1000000000000
11111111111111111111111111000000000000